# .# .# .# .# .# .# .# .# .# .
# .P .  .  .  .  .  .  .  .# .
# .  .  .  .  .  .  .  .  .# .
# .  .  .  .  .  .  .  .  .# .
# .  .  .  .  .  .  .  .  .# .
# .  .  .  .  .  .  .  .  .# .
# .  .  .  .  .  .  .  .  .# .
# .  .  .  .  .  .  .  .  .# .
# .  .  .  .  .  .  .  .  .# .
# .# .# .# .# .# .# .# .# .# .