# .# .# .# .# .# .# .# .# .# .
# .P .  .  .  .  .  .  .  .# .
# .  .  .  .  .  .  .  .  .# .
# .  .  .  .  .  .  .  .  .# .
# .  .  .  .  .  .  .  .  .# .
# .  .  .  .  .  .  .  .  .# .
# .  .  .  .  .  .  .  .  .# .
# .  .  .  .  .  .  .  .  .# .
# .  .  .  .  .  .  .  .  .# .
# .  .  .  .  .  .  .  .  .# .
# .  .  .  .  .  .  .  .  .# .
# .Sp.Sn.Sp.Sn.Sp.Sn.Sp.Sn.# .
# .# .# .# .# .# .# .# .# .# .