# .# .# .# .# .# .# .# .# .# .
# .P .  .  .  .  .  .  .P .# .
# .  .  .  .  .  .  .  .  .# .
# .  .  .  .  .  .  .  .  .# .
# .  .  .  .  .  .  .  .  .# .
# .  .  .  .  .  .  .  .  .# .
# .  .  .  .  .  .  .  .  .# .
# .  .  .  .  .  .  .  .  .# .
# .P .  .  .  .  .  .  .P .# .
# .# .# .# .# .# .# .# .# .# .