# .P .# .# .# .# .# .# .# .# .# .# .
# .  .# .  .  .  .  .  .  .  .  .# .
# .  .# .  .# .  .Sp.  .Sp.  .  .# .
# .  .# .  .# .  .  .  .  .  .  .# .
# .  .  .  .# .# .# .# .# .  .# .# .
# .# .# .  .  .  .  .  .  .  .  .# .
# .  .# .  .  .  .  .  .  .  .  .# .
# .  .  .  .# .  .Sn.  .# .  .# .# .
# .  .  .Sn.# .  .  .  .# .  .  .# .
# .Sp.  .  .# .  .# .# .# .  .  .# .
# .  .Sp.  .# .  .  .  .  .  .  .# .
# .# .# .# .# .# .# .# .# .# .# .# .