#1.#1.#1.#1.#1.#1.#1.#1.#1.#1.
#1.P .  .  .  .#1.  .  .  .#1.
#1.#1.#1.#1.  .#1.  .#1.  .#1.
#1.  .Sl.#1.  .#1.Sp.#1.  .#1.
#1.  .#1.#1.  .#1.#1.#1.  .#1.
#1.  .  .  .  .  .  .  .  .#1.
#1.#1.#1.#1.#1.#1.#1.#1.#1.#1.