# .# .# .# .# .# .# .
# .  .P .  .  .  .# .
# .# .  .  .# .  .# .
# .  .  .  .  .  .# .
# .  .  .  .  .  .# .
# .M .  .M .  .  .# .
# .# .# .# .# .# .# .