# .# .# .# .# .# .# .# .# .# .
# .  .  .  .  .  .  .  .  .# .
# .  .  .P .  .  .  .  .  .# .
# .  .  .Sn.  .  .  .  .  .# .
# .  .  .  .  .  .  .  .  .# .
# .  .  .  .  .  .  .  .  .# .
# .  .  .  .  .  .  .  .  .# .
# .  .  .  .  .  .  .  .  .# .
# .  .  .  .  .  .  .  .  .# .
# .# .# .# .# .# .# .# .# .# .