# .# .# .# .# .# .# .
# .  .P .  .  .  .# .
# .# .  .  .# .  .# .
# .  .  .  .  .  .# .
# .  .  .  .  .  .# .
# .Sp.  .Sn.  .  .# .
# .# .# .# .# .# .# .