# .# .# .# .# .# .# .# .# .# .# .# .# .# .# .# .# .# .# .# .
# .P .  .  .  .  .  .  .  .  .  .  .# .# .# .# .# .# .# .# .
# .  .  .  .  .  .  .  .  .  .  .  .# .# .# .# .# .# .# .# .
# .  .  .Sn.  .  .  .  .  .  .  .  .# .# .# .# .# .# .# .# .
# .  .  .  .  .  .  .  .  .  .  .  .# .# .# .# .# .# .# .# .
# .  .  .  .  .  .  .  .  .  .  .  .# .# .# .# .# .# .# .# .
# .  .  .  .  .  .  .  .  .  .  .  .# .# .# .# .# .# .# .# .
# .  .  .  .  .  .  .  .  .  .  .  .# .# .# .# .# .# .# .# .
# .  .  .  .  .  .  .  .  .  .  .  .# .# .# .# .# .# .# .# .
# .  .  .  .  .  .  .  .  .  .  .  .# .# .# .# .# .# .# .# .
# .  .  .  .  .  .  .  .  .  .  .  .# .# .# .# .# .# .# .# .
# .# .# .# .# .# .# .# .# .# .# .# .# .# .# .# .# .# .# .# .
# .# .# .# .# .# .# .# .# .# .# .# .# .# .# .# .# .# .# .# .