# .# .# .# .# .#0.#1.#2.#3.#4.
# .  .P .Sp.  .#0.#1.#2.#3.#4.
# .# .  .# .  .#0.#1.#2.#3.#4.
# .  .# .  .  .#0.#1.#2.#3.#4.
  .  .  .  .  .  .  .  .  .  .
#0.#0.  .#1.#1.  .#2.#2.  .# .
#0.#0.  .#1.#1.  .#2.#2.  .# .
  .  .  .  .  .  .  .  .  .# .
#3.#3.  .#4.#4.  .  .  .  .# .
#3.#3.  .#4.#4.  .  .  .  .# .