# .# .# .# .# .# .# .# .# .# .
# .P .# .  .  .  .  .  .  .# .
# .  .# .# .  .  .  .  .  .# .
# .Mi.  .# .  .  .  .  .  .# .
# .# .# .# .  .  .  .  .  .# .
# .  .  .  .  .  .  .  .  .# .
# .  .  .  .  .  .  .  .  .# .
# .  .  .  .  .  .  .  .  .# .
# .  .  .  .  .  .  .  .  .# .
# .  .  .  .  .  .  .  .  .# .
# .  .  .  .  .  .  .  .  .# .
# .  .  .  .  .  .  .  .  .# .
# .# .# .# .# .# .# .# .# .# .