# .# .# .# .# .# .# .# .# .# .
# .  .P .Sp.  .  .  .  .  .# .
# .# .  .# .  .  .  .  .  .# .
# .  .# .  .  .  .  .  .  .# .
# .  .  .  .  .  .  .  .  .# .
# .# .  .# .# .# .  .# .# .# .
# .  .  .  .  .# .  .  .  .# .
# .  .  .  .  .# .  .  .  .# .
# .  .  .  .  .# .  .  .  .# .
# .# .# .# .# .# .# .# .# .# .