# .# .# .# .# .# .# .# .# .# .# .
# ..# .  .  .  .  .  .  .  .  .# .
# . .# .  .# .  .  .  .  .  .  .# .
# .  .# .  .# .  .  .  . .  .
# .  .  .  .# .# .# .# .# .  .# .# .
# .# .# .  .  .  .  .  .  .  .  .# .
# .  .# .  .  .  .P .  .  .  .  .# .
# .  .  .  .# .  .# .# .# .# .# .# .
# .  .  .  .# .Go.Sp.  .  .  .  .# .
# .  .  .  .# .  .  .  .  .  .  .# .
# .  .  .  .# .Sp.  .  .  .  .  .# .
# .# .# .# .# .# .# .# .# .# .# .# .