# .# .# .# .# .# .# .# .# .# .# .# .# .
# .P .  .  .  .  .  .  .  .  .  .  .# .
# .  .  .  .  .  .  .  .  .  .  .  .# .
# .  .  .Sn.  .  .  .  .  .  .  .  .# .
# .  .  .  .  .  .  .  .  .  .  .  .# .
# .  .  .  .  .  .  .  .  .  .  .  .# .
# .  .  .  .  .  .  .  .  .  .  .  .# .
# .  .  .  .  .  .  .  .  .  .  .  .# .
# .  .  .  .  .  .  .  .  .  .  .  .# .
# .  .  .  .  .  .  .  .  .  .  .  .# .
# .  .  .  .  .  .  .  .  .  .  .  .# .
# .  .  .  .  .  .  .  .  .  .  .  .# .
# .# .# .# .# .# .# .# .# .# .# .# .# .