# .# .# .# .# .# .# .# .# .# .
# .  .P .  .  .  .  .  .  .# .
# .# .  .# .  .  .  .  .  .# .
# .  .# .  .  .  .  .  .  .# .
# .  .  .  .  .  .  .  .  .# .
# .  .  .  .  .  .  .  .  .# .
# .  .  .  .  .  .  .  .  .# .
# .  .  .  .  .  .  .  .  .# .
# .  .  .  .  .  .  .  .  .# .
# .# .# .# .# .# .# .# .# .# .