# .# .# .# .# .# .# .
# .  .  .  .  .  .# .
# .# .  .  .# .  .# .
# .  .  .  .  .  .# .
# .  .  .  .  .  .# .
# .Sp.  .Sn.  .  .# .
# .# .# .# .# .# .# .