#1.#1.#1.#1.#1.#1.#1.#2.#1.#2.#1.
#1.  .  .  .  .  .#2.  .Sp.  .#2.
#1.  .  .#1.  .  .#1.  .  .  .#1.
#1.  .  .#1.  .  .  .  .  .  .#2.
#1.  .  .#1.  .  .#1.  .  .  .#1.
#1.  .  .#1.  .  .#2.  .  .  .#2.
#1.  .  .#1.  .  .#1.  .Sp.  .#1.
#1.  .Sp.#1.  .  .#2.  .  .  .#2.
#1.  .  .#1.Sl.  .#1.#2.#1.#2.#1.
#1.#1.#1.#1.  .  .#1.#1.#1.#1.#1.
#1.P .  .Sl.  .  .  .  .Sl.  .#1.
#1.#1.#1.#1.#1.#1.#1.#1.#1.#1.#1.