# .# .# .# .# .
# .  .P .  .# .
# .  .  .  .# .
# .M .  .M .# .
# .# .# .# .# .