# .# .# .# .# .# .
# .  .P .  .  .# .
# .# .  .  .# .# .
# .  .  .  .  .# .
# .M .  .M .  .# .
# .# .# .# .# .# .