# .# .# .# .# .
# .  .P .  .# .
# .  .  .  .# .
# .  .M .  .# .
# .# .# .# .# .